person - insan
bicycle - bisiklet
car - araba
motorbike - motor
aeroplane - uÃ§ak
bus - otobÃ¼s
train - tren
truck - kamyon
boat - tekne
traffic light - trafik Ä±ÅŸÄ±ÄŸÄ±
fire hydrant - yangÄ±n musluÄŸu
stop sign - dur iÅŸareti
parking meter - parkmetre
bench - bank
bird - kuÅŸ
cat - kedi
dog - kÃ¶pek
horse - at
sheep - koyun
cow - inek
elephant - fil
bear - ayÄ±
zebra - zebra
giraffe - zÃ¼rafa
backpack - sÄ±rt Ã§antasÄ±
umbrella - ÅŸemsiye
handbag - el Ã§antasÄ±
tie - kravat
suitcase - bavul
frisbee - frizbee
skis - kayaklar
snowboard - snowboard
sports ball - spor topu
kite - uÃ§urtma
baseball bat - beysbol sopasÄ±
baseball glove - beyzbol eldiveni
skateboard - kaykay
surfboard - sÃ¶rf tahtasÄ±
tennis racket -
bottle - ÅŸiÅŸe ğŸ¶
wine glass - ÅŸarap bardaÄŸÄ±
cup - bardak
fork - Ã§atal
knife - bÄ±Ã§ak
spoon - kaÅŸÄ±k
bowl - kase
banana - muz
apple - elma
sandwich - sandviÃ§
orange - portakal
broccoli - brokoli
carrot - havuÃ§
hot dog - sosis
pizza - piza
donut - Ã§Ã¶rek
cake - kek
chair - sandalye
sofa - kenepe
potted plant - saksÄ± bitkisi
bed - yatak
dining table - yemek masasÄ±
toilet - tuvalet
tvmonitor - tv ekranÄ±
laptop - dizÃ¼stÃ¼ bilgisayar
mouse - fare
remote - uzaktan kumanda
keyboard - klavye
cell phone - telefon
microwave - mikro dalga
oven - fÄ±rÄ±n
toaster - tost makinesi
sink - lavabo
refrigerator - buzdolabÄ±
book - kitap
clock - saat
vase - vazo
scissors - makas
teddy bear - oyuncak ayÄ±
hair drier - saÃ§ kurutma makinesi
toothbrush - diÅŸ fÄ±rÃ§asÄ±
